###############
#.............#
#.#.#########.# 
#.#.......#...#
#.#####.#.##.#.
#.....#.#.#...#
#.###.#.#.#.###
#.#...#...#...#
#.#.#########.#
#..........E..#